border_size=1
usage=map

Gg          , Gg          , Gg          , Gg          , Gg          , Gg          , Gg          , Gg          , Gg          , Gg          , Gg          , Gg          , Gg          , Gg          , Gg          , Gg          , Gg          , Gg          , Gg          , Gg          , Gg          , Gg          , Gg          , Gg          , Gg          , Gg          , Gg          , Gg          , Gg          , Gg          , Gg          , Gg          , Gg          , Gg          , Gg          , Gg          , Gg          , Gg          , Gg          , Gg          , Gg          , Gg          , Gg          , Gg          , Gg          , Gg          , Gg          , Gg          , Gg          , Gg          , Gg          , Gg          , Gg          , Gg          , Gg          , Gg          , Gg          , Gg          , Gg          , Gg          , Gg          , Gg          
Gg          , Gg          , Wo         , Gg          , Gg          , Gg          , Gg          , Gg          , Gg          , Gg          , Gg          , Gg          , Gg          , Gg          , Gg          , Gg          , Gg          , Gg          , Gg          , Gg          , Gg          , Gg          , Gg          , Gg          , Gg          , Gg          , Gg          , Gg          , Gg          , Gg          , Gg          , Gg          , Gg          , Gg          , Gg          , Gg          , Gg          , Gg          , Gg          , Gg          , Gg          , Gg          , Gg          , Gg          , Gg          , Gg          , Gg          , Gg          , Gg          , Gg          , Gg          , Gg          , Gg          , Gg          , Gg          , Gg          , Gg          , Gg          , Gg          , Gg          , Gg          , Gg          
Gg          , Gg          , Wo         , Wo         , Wo         , Wo         , Wo         , Gg          , Gg          , Gg          , Wo         , Wo         , Wo         , Gg          , Gg          , Gg          , Wo         , Wo         , Wo         , Gg          , Gg          , Wo         , Gg          , Wo         , Wo         , Gg          , Gg          , Gg          , Gg          , Gg          , Wo         , Wo         , Wo         , Wo         , Wo         , Wo         , Wo         , Gg          , Gg          , Wo         , Wo         , Gg          , Gg          , Gg          , Wo         , Wo         , Gg          , Gg          , Gg          , 1 Gg        , Gg          , Gg          , Gg          , Gg          , Gg          , Gg          , Gg          , Gg          , Gg          , Gg          , Gg          , Gg          
Gg          , Gg          , Wo         , Gg          , Gg          , Gg          , Wo         , Gg          , Gg          , Wo         , Gg          , Gg          , Gg          , Wo         , Gg          , Gg          , Wo         , Gg          , Wo         , Gg          , Gg          , Wo         , Gg          , Wo         , Gg          , Wo         , Wo         , Gg          , Gg          , Gg          , Wo         , Gg          , Gg          , Gg          , Gg          , Gg          , Wo         , Gg          , Gg          , Wo         , Gg          , Wo         , Gg          , Wo         , Gg          , Wo         , Gg          , Gg          , Gg          , 2 Gg        , Gg          , Gg          , Gg          , Gg          , Gg          , Gg          , Gg          , Gg          , Gg          , Gg          , Gg          , Gg          
Gg          , Gg          , Wo         , Gg          , Gg          , Gg          , Wo         , Gg          , Gg          , Wo         , Gg          , Gg          , Gg          , Wo         , Gg          , Gg          , Wo         , Gg          , Wo         , Gg          , Gg          , Wo         , Gg          , Wo         , Gg          , Gg          , Gg          , Wo         , Wo         , Gg          , Wo         , Gg          , Gg          , Gg          , Gg          , Gg          , Wo         , Gg          , Gg          , Wo         , Gg          , Wo         , Wo         , Wo         , Gg          , Wo         , Gg          , Gg          , Gg          , 3 Gg        , Gg          , Gg          , Gg          , Gg          , Gg          , Gg          , Gg          , Gg          , Gg          , Gg          , Gg          , Gg          
Gg          , Gg          , Wo         , Wo         , Wo         , Wo         , Gg          , Gg          , Gg          , Wo         , Gg          , Gg          , Gg          , Wo         , Gg          , Gg          , Wo         , Gg          , Wo         , Gg          , Gg          , Wo         , Gg          , Wo         , Gg          , Gg          , Gg          , Gg          , Wo         , Gg          , Wo         , Gg          , Gg          , Gg          , Gg          , Gg          , Wo         , Gg          , Gg          , Wo         , Gg          , Gg          , Gg          , Gg          , Gg          , Wo         , Gg          , Gg          , Gg          , 4 Gg        , Gg          , Gg          , Gg          , Gg          , Gg          , Gg          , Gg          , Gg          , Gg          , Gg          , Gg          , Gg          
Gg          , Gg          , Wo         , Wo         , Gg          , Wo         , Wo         , Gg          , Wo         , Wo         , Wo         , Wo         , Wo         , Wo         , Wo         , Gg          , Wo         , Gg          , Gg          , Wo         , Gg          , Wo         , Gg          , Wo         , Gg          , Gg          , Gg          , Gg          , Wo         , Gg          , Wo         , Gg          , Gg          , Gg          , Gg          , Gg          , Wo         , Gg          , Gg          , Wo         , Gg          , Gg          , Gg          , Gg          , Gg          , Wo         , Gg          , Gg          , Gg          , 5 Gg        , Gg          , Gg          , Gg          , Gg          , Gg          , Gg          , Gg          , Gg          , Gg          , Gg          , Gg          , Gg          
Gg          , Gg          , Wo         , Gg          , Gg          , Gg          , Wo         , Gg          , Wo         , Gg          , Gg          , Gg          , Gg          , Gg          , Wo         , Gg          , Wo         , Gg          , Gg          , Wo         , Gg          , Wo         , Gg          , Wo         , Gg          , Gg          , Gg          , Gg          , Wo         , Gg          , Wo         , Gg          , Gg          , Gg          , Gg          , Gg          , Wo         , Gg          , Gg          , Wo         , Gg          , Gg          , Gg          , Gg          , Gg          , Wo         , Gg          , Gg          , Gg          , 6 Gg        , Gg          , Gg          , Gg          , Gg          , Gg          , Gg          , Gg          , Gg          , Gg          , Gg          , Gg          , Gg          
Gg          , Gg          , Wo         , Gg          , Gg          , Gg          , Wo         , Gg          , Wo         , Gg          , Gg          , Gg          , Gg          , Gg          , Wo         , Gg          , Wo         , Gg          , Gg          , Wo         , Gg          , Wo         , Gg          , Wo         , Gg          , Gg          , Wo         , Wo         , Gg          , Gg          , Wo         , Gg          , Gg          , Gg          , Gg          , Gg          , Wo         , Gg          , Gg          , Wo         , Gg          , Gg          , Gg          , Gg          , Gg          , Wo         , Gg          , Gg          , Gg          , 7 Gg        , Gg          , Gg          , Gg          , Gg          , Gg          , Gg          , Gg          , Gg          , Gg          , Gg          , Gg          , Gg          
Gg          , Gg          , Wo         , Gg          , Gg          , Gg          , Wo         , Gg          , Wo         , Gg          , Gg          , Gg          , Gg          , Gg          , Wo         , Gg          , Wo         , Gg          , Gg          , Wo         , Wo         , Wo         , Gg          , Wo         , Wo         , Wo         , Gg          , Gg          , Gg          , Gg          , Wo         , Wo         , Wo         , Wo         , Wo         , Wo         , Wo         , Gg          , Gg          , Wo         , Gg          , Gg          , Gg          , Gg          , Gg          , Wo         , Gg          , Gg          , Gg          , 8 Gg        , Gg          , Gg          , Gg          , Gg          , Gg          , Gg          , Gg          , Gg          , Gg          , Gg          , Gg          , Gg          
Gg          , Gg          , Gg          , Gg          , Gg          , Gg          , Gg          , Gg          , Gg          , Gg          , Gg          , Gg          , Gg          , Gg          , Gg          , Gg          , Gg          , Gg          , Gg          , Gg          , Gg          , Gg          , Gg          , Gg          , Gg          , Gg          , Gg          , Gg          , Gg          , Gg          , Gg          , Gg          , Gg          , Gg          , Gg          , Gg          , Gg          , Gg          , Gg          , Wo         , Gg          , Gg          , Gg          , Gg          , Gg          , Wo         , Gg          , Gg          , Gg          , 9 Gg        , Gg          , Gg          , Gg          , Gg          , Gg          , Gg          , Gg          , Gg          , Gg          , Gg          , Gg          , Gg          
Gg          , Gg          , Gg          , Gg          , Gg          , Gg          , Gg          , Gg          , Gg          , Gg          , Gg          , Gg          , Gg          , Gg          , Gg          , Gg          , Gg          , Gg          , Gg          , Gg          , Gg          , Gg          , Gg          , Gg          , Gg          , Gg          , Gg          , Gg          , Gg          , Gg          , Gg          , Gg          , Gg          , Gg          , Gg          , Gg          , Gg          , Gg          , Gg          , Gg          , Gg          , Gg          , Gg          , Gg          , Gg          , Gg          , Gg          , Gg          , Gg          , Gg          , Gg          , Gg          , Gg          , Gg          , Gg          , Gg          , Gg          , Gg          , Gg          , Gg          , Gg          , Gg          
Gg          , Gg          , Wo         , Gg          , Wo         , Gg          , Wo         , Gg          , Gg          , Gg          , Gg          , Gg          , Gg          , Gg          , Gg          , Gg          , Gg          , Gg          , Gg          , Gg          , Gg          , Gg          , Gg          , Gg          , Gg          , Gg          , Gg          , Gg          , Gg          , Gg          , Gg          , Gg          , Gg          , Gg          , Gg          , Gg          , Gg          , Gg          , Gg          , Gg          , Gg          , Gg          , Gg          , Gg          , Gg          , Gg          , Gg          , Gg          , Gg          , Gg          , Gg          , Gg          , Gg          , Gg          , Gg          , Gg          , Gg          , Gg          , Gg          , Gg          , Gg          , Gg          
Gg          , Gg          , Wo         , Wo         , Gg          , Wo         , Gg          , Wo         , Gg          , Gg          , Gg          , Gg          , Wo         , Wo         , Wo         , Gg          , Gg          , Gg          , Wo         , Gg          , Gg          , Gg          , Gg          , Gg          , Wo         , Gg          , Wo         , Wo         , Wo         , Wo         , Wo         , Gg          , Gg          , Gg          , Wo         , Wo         , Wo         , Gg          , Gg          , Gg          , Wo         , Wo         , Wo         , Wo         , Wo         , Gg          , Wo         , Wo         , Wo         , Wo         , Wo         , Gg          , Gg          , Wo         , Wo         , Gg          , Gg          , Gg          , Gg          , Wo         , Gg          , Gg          
Gg          , Gg          , Wo         , Gg          , Gg          , Gg          , Gg          , Wo         , Gg          , Gg          , Gg          , Wo         , Gg          , Gg          , Gg          , Wo         , Gg          , Gg          , Wo         , Wo         , Wo         , Gg          , Wo         , Wo         , Wo         , Gg          , Wo         , Gg          , Gg          , Gg          , Wo         , Gg          , Gg          , Wo         , Gg          , Gg          , Gg          , Wo         , Gg          , Gg          , Gg          , Gg          , Wo         , Gg          , Gg          , Gg          , Wo         , Gg          , Gg          , Gg          , Gg          , Wo         , Gg          , Wo         , Gg          , Wo         , Gg          , Gg          , Gg          , Wo         , Gg          , Gg          
Gg          , Gg          , Wo         , Gg          , Gg          , Gg          , Gg          , Gg          , Gg          , Gg          , Gg          , Wo         , Gg          , Gg          , Gg          , Wo         , Gg          , Gg          , Wo         , Gg          , Wo         , Gg          , Wo         , Gg          , Wo         , Gg          , Wo         , Gg          , Gg          , Gg          , Wo         , Gg          , Gg          , Wo         , Gg          , Gg          , Gg          , Wo         , Gg          , Gg          , Gg          , Gg          , Wo         , Gg          , Gg          , Gg          , Wo         , Gg          , Gg          , Gg          , Gg          , Gg          , Gg          , Wo         , Gg          , Wo         , Gg          , Gg          , Gg          , Wo         , Gg          , Gg          
Gg          , Gg          , Wo         , Gg          , Gg          , Gg          , Gg          , Gg          , Gg          , Gg          , Wo         , Wo         , Wo         , Wo         , Wo         , Wo         , Wo         , Gg          , Wo         , Gg          , Gg          , Wo         , Gg          , Gg          , Wo         , Gg          , Wo         , Gg          , Wo         , Gg          , Wo         , Gg          , Wo         , Wo         , Wo         , Wo         , Wo         , Wo         , Wo         , Gg          , Gg          , Gg          , Wo         , Gg          , Gg          , Gg          , Wo         , Gg          , Gg          , Gg          , Wo         , Gg          , Gg          , Wo         , Gg          , Wo         , Wo         , Gg          , Gg          , Wo         , Gg          , Gg          
Gg          , Gg          , Wo         , Gg          , Gg          , Gg          , Gg          , Gg          , Gg          , Gg          , Wo         , Gg          , Gg          , Gg          , Gg          , Gg          , Wo         , Gg          , Wo         , Gg          , Gg          , Gg          , Gg          , Gg          , Wo         , Gg          , Wo         , Wo         , Gg          , Wo         , Gg          , Gg          , Wo         , Gg          , Gg          , Gg          , Gg          , Gg          , Wo         , Gg          , Gg          , Gg          , Wo         , Gg          , Gg          , Gg          , Wo         , Gg          , Gg          , Wo         , Gg          , Wo         , Gg          , Wo         , Gg          , Gg          , Gg          , Wo         , Gg          , Wo         , Gg          , Gg          
Gg          , Gg          , Wo         , Gg          , Gg          , Gg          , Gg          , Wo         , Gg          , Gg          , Wo         , Gg          , Gg          , Gg          , Gg          , Gg          , Wo         , Gg          , Wo         , Gg          , Gg          , Gg          , Gg          , Gg          , Wo         , Gg          , Wo         , Gg          , Gg          , Gg          , Gg          , Gg          , Wo         , Gg          , Gg          , Gg          , Gg          , Gg          , Wo         , Gg          , Gg          , Gg          , Wo         , Gg          , Gg          , Gg          , Wo         , Gg          , Gg          , Gg          , Gg          , Wo         , Gg          , Wo         , Gg          , Gg          , Gg          , Wo         , Gg          , Wo         , Gg          , Gg          
Gg          , Gg          , Wo         , Wo         , Wo         , Wo         , Wo         , Wo         , Gg          , Gg          , Wo         , Gg          , Gg          , Gg          , Gg          , Gg          , Wo         , Gg          , Wo         , Gg          , Gg          , Gg          , Gg          , Gg          , Wo         , Gg          , Wo         , Gg          , Gg          , Gg          , Gg          , Gg          , Wo         , Gg          , Gg          , Gg          , Gg          , Gg          , Wo         , Gg          , Wo         , Wo         , Gg          , Wo         , Wo         , Gg          , Wo         , Wo         , Wo         , Wo         , Wo         , Wo         , Gg          , Wo         , Gg          , Gg          , Gg          , Wo         , Wo         , Wo         , Gg          , Gg          
Gg          , Gg          , Gg          , Gg          , Gg          , Gg          , Gg          , Gg          , Gg          , Gg          , Gg          , Gg          , Gg          , Gg          , Gg          , Gg          , Gg          , Gg          , Gg          , Gg          , Gg          , Gg          , Gg          , Gg          , Gg          , Gg          , Gg          , Gg          , Gg          , Gg          , Gg          , Gg          , Gg          , Gg          , Gg          , Gg          , Gg          , Gg          , Gg          , Gg          , Gg          , Gg          , Gg          , Gg          , Gg          , Gg          , Gg          , Gg          , Gg          , Gg          , Gg          , Gg          , Gg          , Wo         , Gg          , Gg          , Gg          , Gg          , Gg          , Wo         , Gg          , Gg          
Gg          , Gg          , Gg          , Gg          , Gg          , Gg          , Gg          , Gg          , Gg          , Gg          , Gg          , Gg          , Gg          , Gg          , Gg          , Gg          , Gg          , Gg          , Gg          , Gg          , Gg          , Gg          , Gg          , Gg          , Gg          , Gg          , Gg          , Gg          , Gg          , Gg          , Gg          , Gg          , Gg          , Gg          , Gg          , Gg          , Gg          , Gg          , Gg          , Gg          , Gg          , Gg          , Gg          , Gg          , Gg          , Gg          , Gg          , Gg          , Gg          , Gg          , Gg          , Gg          , Gg          , Gg          , Gg          , Gg          , Gg          , Gg          , Gg          , Gg          , Gg          , Gg          
