border_size=1
usage=map

Gg          , Gg          , Gg          , Gg          , Gg          , Gg          , Gg          , Gg          , Gg          , Gg          , Gg          , Gg          , Gg          , Gg          , Gg          , Gg          , Gg          , Gg          , Gg          , Gg          , Gg          , Gg          , Gg          , Gg          , Gg          , Gg          , Gg          , Gg          , Gg          , Gg          , Gg          , Gg          , Gg          , Gg          , Gg          , Gg          , Gg          , Gg          , Gg          , Gg          , Gg          , Gg          , Gg          , Gg          , Gg          , Gg          , Gg          , Gg          , Gg          , Gg          , Gg          , Gg          , Gg          , Gg          , Gg          , Gg          , Gg          , Gg          , Gg          , Gg          , Gg          , Gg          
Gg          , Gg          , Rrc         , Gg          , Gg          , Gg          , Gg          , Gg          , Gg          , Gg          , Gg          , Gg          , Gg          , Gg          , Gg          , Gg          , Gg          , Gg          , Gg          , Gg          , Gg          , Gg          , Gg          , Gg          , Gg          , Gg          , Gg          , Gg          , Gg          , Gg          , Gg          , Gg          , Gg          , Gg          , Gg          , Gg          , Gg          , Gg          , Gg          , Gg          , Gg          , Gg          , Gg          , Gg          , Gg          , Gg          , Gg          , Gg          , Gg          , Gg          , Gg          , Gg          , Gg          , Gg          , Gg          , Gg          , Gg          , Gg          , Gg          , Gg          , Gg          , Gg          
Gg          , Gg          , Rrc         , Rrc         , Rrc         , Rrc         , Rrc         , Gg          , Gg          , Gg          , Rrc         , Rrc         , Rrc         , Gg          , Gg          , Gg          , Rrc         , Rrc         , Rrc         , Gg          , Gg          , Rrc         , Gg          , Rrc         , Rrc         , Gg          , Gg          , Gg          , Gg          , Gg          , Rrc         , Rrc         , Rrc         , Rrc         , Rrc         , Rrc         , Rrc         , Gg          , Gg          , Rrc         , Rrc         , Gg          , Gg          , Gg          , Rrc         , Rrc         , Gg          , Gg          , Gg          , 1 Gg        , Gg          , Gg          , Gg          , Gg          , Gg          , Gg          , Gg          , Gg          , Gg          , Gg          , Gg          , Gg          
Gg          , Gg          , Rrc         , Gg          , Gg          , Gg          , Rrc         , Gg          , Gg          , Rrc         , Gg          , Gg          , Gg          , Rrc         , Gg          , Gg          , Rrc         , Gg          , Rrc         , Gg          , Gg          , Rrc         , Gg          , Rrc         , Gg          , Rrc         , Rrc         , Gg          , Gg          , Gg          , Rrc         , Gg          , Gg          , Gg          , Gg          , Gg          , Rrc         , Gg          , Gg          , Rrc         , Gg          , Rrc         , Gg          , Rrc         , Gg          , Rrc         , Gg          , Gg          , Gg          , 2 Gg        , Gg          , Gg          , Gg          , Gg          , Gg          , Gg          , Gg          , Gg          , Gg          , Gg          , Gg          , Gg          
Gg          , Gg          , Rrc         , Gg          , Gg          , Gg          , Rrc         , Gg          , Gg          , Rrc         , Gg          , Gg          , Gg          , Rrc         , Gg          , Gg          , Rrc         , Gg          , Rrc         , Gg          , Gg          , Rrc         , Gg          , Rrc         , Gg          , Gg          , Gg          , Rrc         , Rrc         , Gg          , Rrc         , Gg          , Gg          , Gg          , Gg          , Gg          , Rrc         , Gg          , Gg          , Rrc         , Gg          , Rrc         , Rrc         , Rrc         , Gg          , Rrc         , Gg          , Gg          , Gg          , 3 Gg        , Gg          , Gg          , Gg          , Gg          , Gg          , Gg          , Gg          , Gg          , Gg          , Gg          , Gg          , Gg          
Gg          , Gg          , Rrc         , Rrc         , Rrc         , Rrc         , Gg          , Gg          , Gg          , Rrc         , Gg          , Gg          , Gg          , Rrc         , Gg          , Gg          , Rrc         , Gg          , Rrc         , Gg          , Gg          , Rrc         , Gg          , Rrc         , Gg          , Gg          , Gg          , Gg          , Rrc         , Gg          , Rrc         , Gg          , Gg          , Gg          , Gg          , Gg          , Rrc         , Gg          , Gg          , Rrc         , Gg          , Gg          , Gg          , Gg          , Gg          , Rrc         , Gg          , Gg          , Gg          , 4 Gg        , Gg          , Gg          , Gg          , Gg          , Gg          , Gg          , Gg          , Gg          , Gg          , Gg          , Gg          , Gg          
Gg          , Gg          , Rrc         , Rrc         , Gg          , Rrc         , Rrc         , Gg          , Rrc         , Rrc         , Rrc         , Rrc         , Rrc         , Rrc         , Rrc         , Gg          , Rrc         , Gg          , Gg          , Rrc         , Gg          , Rrc         , Gg          , Rrc         , Gg          , Gg          , Gg          , Gg          , Rrc         , Gg          , Rrc         , Gg          , Gg          , Gg          , Gg          , Gg          , Rrc         , Gg          , Gg          , Rrc         , Gg          , Gg          , Gg          , Gg          , Gg          , Rrc         , Gg          , Gg          , Gg          , 5 Gg        , Gg          , Gg          , Gg          , Gg          , Gg          , Gg          , Gg          , Gg          , Gg          , Gg          , Gg          , Gg          
Gg          , Gg          , Rrc         , Gg          , Gg          , Gg          , Rrc         , Gg          , Rrc         , Gg          , Gg          , Gg          , Gg          , Gg          , Rrc         , Gg          , Rrc         , Gg          , Gg          , Rrc         , Gg          , Rrc         , Gg          , Rrc         , Gg          , Gg          , Gg          , Gg          , Rrc         , Gg          , Rrc         , Gg          , Gg          , Gg          , Gg          , Gg          , Rrc         , Gg          , Gg          , Rrc         , Gg          , Gg          , Gg          , Gg          , Gg          , Rrc         , Gg          , Gg          , Gg          , 6 Gg        , Gg          , Gg          , Gg          , Gg          , Gg          , Gg          , Gg          , Gg          , Gg          , Gg          , Gg          , Gg          
Gg          , Gg          , Rrc         , Gg          , Gg          , Gg          , Rrc         , Gg          , Rrc         , Gg          , Gg          , Gg          , Gg          , Gg          , Rrc         , Gg          , Rrc         , Gg          , Gg          , Rrc         , Gg          , Rrc         , Gg          , Rrc         , Gg          , Gg          , Rrc         , Rrc         , Gg          , Gg          , Rrc         , Gg          , Gg          , Gg          , Gg          , Gg          , Rrc         , Gg          , Gg          , Rrc         , Gg          , Gg          , Gg          , Gg          , Gg          , Rrc         , Gg          , Gg          , Gg          , 7 Gg        , Gg          , Gg          , Gg          , Gg          , Gg          , Gg          , Gg          , Gg          , Gg          , Gg          , Gg          , Gg          
Gg          , Gg          , Rrc         , Gg          , Gg          , Gg          , Rrc         , Gg          , Rrc         , Gg          , Gg          , Gg          , Gg          , Gg          , Rrc         , Gg          , Rrc         , Gg          , Gg          , Rrc         , Rrc         , Rrc         , Gg          , Rrc         , Rrc         , Rrc         , Gg          , Gg          , Gg          , Gg          , Rrc         , Rrc         , Rrc         , Rrc         , Rrc         , Rrc         , Rrc         , Gg          , Gg          , Rrc         , Gg          , Gg          , Gg          , Gg          , Gg          , Rrc         , Gg          , Gg          , Gg          , 8 Gg        , Gg          , Gg          , Gg          , Gg          , Gg          , Gg          , Gg          , Gg          , Gg          , Gg          , Gg          , Gg          
Gg          , Gg          , Gg          , Gg          , Gg          , Gg          , Gg          , Gg          , Gg          , Gg          , Gg          , Gg          , Gg          , Gg          , Gg          , Gg          , Gg          , Gg          , Gg          , Gg          , Gg          , Gg          , Gg          , Gg          , Gg          , Gg          , Gg          , Gg          , Gg          , Gg          , Gg          , Gg          , Gg          , Gg          , Gg          , Gg          , Gg          , Gg          , Gg          , Rrc         , Gg          , Gg          , Gg          , Gg          , Gg          , Rrc         , Gg          , Gg          , Gg          , 9 Gg        , Gg          , Gg          , Gg          , Gg          , Gg          , Gg          , Gg          , Gg          , Gg          , Gg          , Gg          , Gg          
Gg          , Gg          , Gg          , Gg          , Gg          , Gg          , Gg          , Gg          , Gg          , Gg          , Gg          , Gg          , Gg          , Gg          , Gg          , Gg          , Gg          , Gg          , Gg          , Gg          , Gg          , Gg          , Gg          , Gg          , Gg          , Gg          , Gg          , Gg          , Gg          , Gg          , Gg          , Gg          , Gg          , Gg          , Gg          , Gg          , Gg          , Gg          , Gg          , Gg          , Gg          , Gg          , Gg          , Gg          , Gg          , Gg          , Gg          , Gg          , Gg          , Gg          , Gg          , Gg          , Gg          , Gg          , Gg          , Gg          , Gg          , Gg          , Gg          , Gg          , Gg          , Gg          
Gg          , Gg          , Rrc         , Gg          , Rrc         , Gg          , Rrc         , Gg          , Gg          , Gg          , Gg          , Gg          , Gg          , Gg          , Gg          , Gg          , Gg          , Gg          , Gg          , Gg          , Gg          , Gg          , Gg          , Gg          , Gg          , Gg          , Gg          , Gg          , Gg          , Gg          , Gg          , Gg          , Gg          , Gg          , Gg          , Gg          , Gg          , Gg          , Gg          , Gg          , Gg          , Gg          , Gg          , Gg          , Gg          , Gg          , Gg          , Gg          , Gg          , Gg          , Gg          , Gg          , Gg          , Gg          , Gg          , Gg          , Gg          , Gg          , Gg          , Gg          , Gg          , Gg          
Gg          , Gg          , Rrc         , Rrc         , Gg          , Rrc         , Gg          , Rrc         , Gg          , Gg          , Gg          , Gg          , Rrc         , Rrc         , Rrc         , Gg          , Gg          , Gg          , Rrc         , Gg          , Gg          , Gg          , Gg          , Gg          , Rrc         , Gg          , Rrc         , Rrc         , Rrc         , Rrc         , Rrc         , Gg          , Gg          , Gg          , Rrc         , Rrc         , Rrc         , Gg          , Gg          , Gg          , Rrc         , Rrc         , Rrc         , Rrc         , Rrc         , Gg          , Rrc         , Rrc         , Rrc         , Rrc         , Rrc         , Gg          , Gg          , Rrc         , Rrc         , Gg          , Gg          , Gg          , Gg          , Rrc         , Gg          , Gg          
Gg          , Gg          , Rrc         , Gg          , Gg          , Gg          , Gg          , Rrc         , Gg          , Gg          , Gg          , Rrc         , Gg          , Gg          , Gg          , Rrc         , Gg          , Gg          , Rrc         , Rrc         , Rrc         , Gg          , Rrc         , Rrc         , Rrc         , Gg          , Rrc         , Gg          , Gg          , Gg          , Rrc         , Gg          , Gg          , Rrc         , Gg          , Gg          , Gg          , Rrc         , Gg          , Gg          , Gg          , Gg          , Rrc         , Gg          , Gg          , Gg          , Rrc         , Gg          , Gg          , Gg          , Gg          , Rrc         , Gg          , Rrc         , Gg          , Rrc         , Gg          , Gg          , Gg          , Rrc         , Gg          , Gg          
Gg          , Gg          , Rrc         , Gg          , Gg          , Gg          , Gg          , Gg          , Gg          , Gg          , Gg          , Rrc         , Gg          , Gg          , Gg          , Rrc         , Gg          , Gg          , Rrc         , Gg          , Rrc         , Gg          , Rrc         , Gg          , Rrc         , Gg          , Rrc         , Gg          , Gg          , Gg          , Rrc         , Gg          , Gg          , Rrc         , Gg          , Gg          , Gg          , Rrc         , Gg          , Gg          , Gg          , Gg          , Rrc         , Gg          , Gg          , Gg          , Rrc         , Gg          , Gg          , Gg          , Gg          , Gg          , Gg          , Rrc         , Gg          , Rrc         , Gg          , Gg          , Gg          , Rrc         , Gg          , Gg          
Gg          , Gg          , Rrc         , Gg          , Gg          , Gg          , Gg          , Gg          , Gg          , Gg          , Rrc         , Rrc         , Rrc         , Rrc         , Rrc         , Rrc         , Rrc         , Gg          , Rrc         , Gg          , Gg          , Rrc         , Gg          , Gg          , Rrc         , Gg          , Rrc         , Gg          , Rrc         , Gg          , Rrc         , Gg          , Rrc         , Rrc         , Rrc         , Rrc         , Rrc         , Rrc         , Rrc         , Gg          , Gg          , Gg          , Rrc         , Gg          , Gg          , Gg          , Rrc         , Gg          , Gg          , Gg          , Rrc         , Gg          , Gg          , Rrc         , Gg          , Rrc         , Rrc         , Gg          , Gg          , Rrc         , Gg          , Gg          
Gg          , Gg          , Rrc         , Gg          , Gg          , Gg          , Gg          , Gg          , Gg          , Gg          , Rrc         , Gg          , Gg          , Gg          , Gg          , Gg          , Rrc         , Gg          , Rrc         , Gg          , Gg          , Gg          , Gg          , Gg          , Rrc         , Gg          , Rrc         , Rrc         , Gg          , Rrc         , Gg          , Gg          , Rrc         , Gg          , Gg          , Gg          , Gg          , Gg          , Rrc         , Gg          , Gg          , Gg          , Rrc         , Gg          , Gg          , Gg          , Rrc         , Gg          , Gg          , Rrc         , Gg          , Rrc         , Gg          , Rrc         , Gg          , Gg          , Gg          , Rrc         , Gg          , Rrc         , Gg          , Gg          
Gg          , Gg          , Rrc         , Gg          , Gg          , Gg          , Gg          , Rrc         , Gg          , Gg          , Rrc         , Gg          , Gg          , Gg          , Gg          , Gg          , Rrc         , Gg          , Rrc         , Gg          , Gg          , Gg          , Gg          , Gg          , Rrc         , Gg          , Rrc         , Gg          , Gg          , Gg          , Gg          , Gg          , Rrc         , Gg          , Gg          , Gg          , Gg          , Gg          , Rrc         , Gg          , Gg          , Gg          , Rrc         , Gg          , Gg          , Gg          , Rrc         , Gg          , Gg          , Gg          , Gg          , Rrc         , Gg          , Rrc         , Gg          , Gg          , Gg          , Rrc         , Gg          , Rrc         , Gg          , Gg          
Gg          , Gg          , Rrc         , Rrc         , Rrc         , Rrc         , Rrc         , Rrc         , Gg          , Gg          , Rrc         , Gg          , Gg          , Gg          , Gg          , Gg          , Rrc         , Gg          , Rrc         , Gg          , Gg          , Gg          , Gg          , Gg          , Rrc         , Gg          , Rrc         , Gg          , Gg          , Gg          , Gg          , Gg          , Rrc         , Gg          , Gg          , Gg          , Gg          , Gg          , Rrc         , Gg          , Rrc         , Rrc         , Gg          , Rrc         , Rrc         , Gg          , Rrc         , Rrc         , Rrc         , Rrc         , Rrc         , Rrc         , Gg          , Rrc         , Gg          , Gg          , Gg          , Rrc         , Rrc         , Rrc         , Gg          , Gg          
Gg          , Gg          , Gg          , Gg          , Gg          , Gg          , Gg          , Gg          , Gg          , Gg          , Gg          , Gg          , Gg          , Gg          , Gg          , Gg          , Gg          , Gg          , Gg          , Gg          , Gg          , Gg          , Gg          , Gg          , Gg          , Gg          , Gg          , Gg          , Gg          , Gg          , Gg          , Gg          , Gg          , Gg          , Gg          , Gg          , Gg          , Gg          , Gg          , Gg          , Gg          , Gg          , Gg          , Gg          , Gg          , Gg          , Gg          , Gg          , Gg          , Gg          , Gg          , Gg          , Gg          , Rrc         , Gg          , Gg          , Gg          , Gg          , Gg          , Rrc         , Gg          , Gg          
Gg          , Gg          , Gg          , Gg          , Gg          , Gg          , Gg          , Gg          , Gg          , Gg          , Gg          , Gg          , Gg          , Gg          , Gg          , Gg          , Gg          , Gg          , Gg          , Gg          , Gg          , Gg          , Gg          , Gg          , Gg          , Gg          , Gg          , Gg          , Gg          , Gg          , Gg          , Gg          , Gg          , Gg          , Gg          , Gg          , Gg          , Gg          , Gg          , Gg          , Gg          , Gg          , Gg          , Gg          , Gg          , Gg          , Gg          , Gg          , Gg          , Gg          , Gg          , Gg          , Gg          , Gg          , Gg          , Gg          , Gg          , Gg          , Gg          , Gg          , Gg          , Gg          
