border_size=1
usage=map

Gg          , Gg          , Gg          , Gg          , Gg          , Gg          , Gg          , Gg          , Gg          , Gg          , Gg          , Gg          , Gg          , Gg          , Gg          , Gg          , Gg          , Gg          , Gg          , Gg          , Gg          , Gg          , Gg          , Gg          , Gg          , Gg          , Gg          , Gg          , Gg          , Gg          , Gg          , Gg          , Gg          , Gg          , Gg          , Gg          , Gg          , Gg          , Gg          , Gg          , Gg          , Gg          , Gg          , Gg          , Gg          , Gg          , Gg          , Gg          , Gg          , Gg          , Gg          , Gg          , Gg          , Gg          , Gg          , Gg          , Gg          , Gg          , Gg          , Gg          , Gg          , Gg          
Gg          , Gg          , Qlf         , Gg          , Gg          , Gg          , Gg          , Gg          , Gg          , Gg          , Gg          , Gg          , Gg          , Gg          , Gg          , Gg          , Gg          , Gg          , Gg          , Gg          , Gg          , Gg          , Gg          , Gg          , Gg          , Gg          , Gg          , Gg          , Gg          , Gg          , Gg          , Gg          , Gg          , Gg          , Gg          , Gg          , Gg          , Gg          , Gg          , Gg          , Gg          , Gg          , Gg          , Gg          , Gg          , Gg          , Gg          , Gg          , Gg          , Gg          , Gg          , Gg          , Gg          , Gg          , Gg          , Gg          , Gg          , Gg          , Gg          , Gg          , Gg          , Gg          
Gg          , Gg          , Qlf         , Qlf         , Qlf         , Qlf         , Qlf         , Gg          , Gg          , Gg          , Qlf         , Qlf         , Qlf         , Gg          , Gg          , Gg          , Qlf         , Qlf         , Qlf         , Gg          , Gg          , Qlf         , Gg          , Qlf         , Qlf         , Gg          , Gg          , Gg          , Gg          , Gg          , Qlf         , Qlf         , Qlf         , Qlf         , Qlf         , Qlf         , Qlf         , Gg          , Gg          , Qlf         , Qlf         , Gg          , Gg          , Gg          , Qlf         , Qlf         , Gg          , Gg          , Gg          , 1 Gg        , Gg          , Gg          , Gg          , Gg          , Gg          , Gg          , Gg          , Gg          , Gg          , Gg          , Gg          , Gg          
Gg          , Gg          , Qlf         , Gg          , Gg          , Gg          , Qlf         , Gg          , Gg          , Qlf         , Gg          , Gg          , Gg          , Qlf         , Gg          , Gg          , Qlf         , Gg          , Qlf         , Gg          , Gg          , Qlf         , Gg          , Qlf         , Gg          , Qlf         , Qlf         , Gg          , Gg          , Gg          , Qlf         , Gg          , Gg          , Gg          , Gg          , Gg          , Qlf         , Gg          , Gg          , Qlf         , Gg          , Qlf         , Gg          , Qlf         , Gg          , Qlf         , Gg          , Gg          , Gg          , 2 Gg        , Gg          , Gg          , Gg          , Gg          , Gg          , Gg          , Gg          , Gg          , Gg          , Gg          , Gg          , Gg          
Gg          , Gg          , Qlf         , Gg          , Gg          , Gg          , Qlf         , Gg          , Gg          , Qlf         , Gg          , Gg          , Gg          , Qlf         , Gg          , Gg          , Qlf         , Gg          , Qlf         , Gg          , Gg          , Qlf         , Gg          , Qlf         , Gg          , Gg          , Gg          , Qlf         , Qlf         , Gg          , Qlf         , Gg          , Gg          , Gg          , Gg          , Gg          , Qlf         , Gg          , Gg          , Qlf         , Gg          , Qlf         , Qlf         , Qlf         , Gg          , Qlf         , Gg          , Gg          , Gg          , 3 Gg        , Gg          , Gg          , Gg          , Gg          , Gg          , Gg          , Gg          , Gg          , Gg          , Gg          , Gg          , Gg          
Gg          , Gg          , Qlf         , Qlf         , Qlf         , Qlf         , Gg          , Gg          , Gg          , Qlf         , Gg          , Gg          , Gg          , Qlf         , Gg          , Gg          , Qlf         , Gg          , Qlf         , Gg          , Gg          , Qlf         , Gg          , Qlf         , Gg          , Gg          , Gg          , Gg          , Qlf         , Gg          , Qlf         , Gg          , Gg          , Gg          , Gg          , Gg          , Qlf         , Gg          , Gg          , Qlf         , Gg          , Gg          , Gg          , Gg          , Gg          , Qlf         , Gg          , Gg          , Gg          , 4 Gg        , Gg          , Gg          , Gg          , Gg          , Gg          , Gg          , Gg          , Gg          , Gg          , Gg          , Gg          , Gg          
Gg          , Gg          , Qlf         , Qlf         , Gg          , Qlf         , Qlf         , Gg          , Qlf         , Qlf         , Qlf         , Qlf         , Qlf         , Qlf         , Qlf         , Gg          , Qlf         , Gg          , Gg          , Qlf         , Gg          , Qlf         , Gg          , Qlf         , Gg          , Gg          , Gg          , Gg          , Qlf         , Gg          , Qlf         , Gg          , Gg          , Gg          , Gg          , Gg          , Qlf         , Gg          , Gg          , Qlf         , Gg          , Gg          , Gg          , Gg          , Gg          , Qlf         , Gg          , Gg          , Gg          , 5 Gg        , Gg          , Gg          , Gg          , Gg          , Gg          , Gg          , Gg          , Gg          , Gg          , Gg          , Gg          , Gg          
Gg          , Gg          , Qlf         , Gg          , Gg          , Gg          , Qlf         , Gg          , Qlf         , Gg          , Gg          , Gg          , Gg          , Gg          , Qlf         , Gg          , Qlf         , Gg          , Gg          , Qlf         , Gg          , Qlf         , Gg          , Qlf         , Gg          , Gg          , Gg          , Gg          , Qlf         , Gg          , Qlf         , Gg          , Gg          , Gg          , Gg          , Gg          , Qlf         , Gg          , Gg          , Qlf         , Gg          , Gg          , Gg          , Gg          , Gg          , Qlf         , Gg          , Gg          , Gg          , 6 Gg        , Gg          , Gg          , Gg          , Gg          , Gg          , Gg          , Gg          , Gg          , Gg          , Gg          , Gg          , Gg          
Gg          , Gg          , Qlf         , Gg          , Gg          , Gg          , Qlf         , Gg          , Qlf         , Gg          , Gg          , Gg          , Gg          , Gg          , Qlf         , Gg          , Qlf         , Gg          , Gg          , Qlf         , Gg          , Qlf         , Gg          , Qlf         , Gg          , Gg          , Qlf         , Qlf         , Gg          , Gg          , Qlf         , Gg          , Gg          , Gg          , Gg          , Gg          , Qlf         , Gg          , Gg          , Qlf         , Gg          , Gg          , Gg          , Gg          , Gg          , Qlf         , Gg          , Gg          , Gg          , 7 Gg        , Gg          , Gg          , Gg          , Gg          , Gg          , Gg          , Gg          , Gg          , Gg          , Gg          , Gg          , Gg          
Gg          , Gg          , Qlf         , Gg          , Gg          , Gg          , Qlf         , Gg          , Qlf         , Gg          , Gg          , Gg          , Gg          , Gg          , Qlf         , Gg          , Qlf         , Gg          , Gg          , Qlf         , Qlf         , Qlf         , Gg          , Qlf         , Qlf         , Qlf         , Gg          , Gg          , Gg          , Gg          , Qlf         , Qlf         , Qlf         , Qlf         , Qlf         , Qlf         , Qlf         , Gg          , Gg          , Qlf         , Gg          , Gg          , Gg          , Gg          , Gg          , Qlf         , Gg          , Gg          , Gg          , 8 Gg        , Gg          , Gg          , Gg          , Gg          , Gg          , Gg          , Gg          , Gg          , Gg          , Gg          , Gg          , Gg          
Gg          , Gg          , Gg          , Gg          , Gg          , Gg          , Gg          , Gg          , Gg          , Gg          , Gg          , Gg          , Gg          , Gg          , Gg          , Gg          , Gg          , Gg          , Gg          , Gg          , Gg          , Gg          , Gg          , Gg          , Gg          , Gg          , Gg          , Gg          , Gg          , Gg          , Gg          , Gg          , Gg          , Gg          , Gg          , Gg          , Gg          , Gg          , Gg          , Qlf         , Gg          , Gg          , Gg          , Gg          , Gg          , Qlf         , Gg          , Gg          , Gg          , 9 Gg        , Gg          , Gg          , Gg          , Gg          , Gg          , Gg          , Gg          , Gg          , Gg          , Gg          , Gg          , Gg          
Gg          , Gg          , Gg          , Gg          , Gg          , Gg          , Gg          , Gg          , Gg          , Gg          , Gg          , Gg          , Gg          , Gg          , Gg          , Gg          , Gg          , Gg          , Gg          , Gg          , Gg          , Gg          , Gg          , Gg          , Gg          , Gg          , Gg          , Gg          , Gg          , Gg          , Gg          , Gg          , Gg          , Gg          , Gg          , Gg          , Gg          , Gg          , Gg          , Gg          , Gg          , Gg          , Gg          , Gg          , Gg          , Gg          , Gg          , Gg          , Gg          , Gg          , Gg          , Gg          , Gg          , Gg          , Gg          , Gg          , Gg          , Gg          , Gg          , Gg          , Gg          , Gg          
Gg          , Gg          , Qlf         , Gg          , Qlf         , Gg          , Qlf         , Gg          , Gg          , Gg          , Gg          , Gg          , Gg          , Gg          , Gg          , Gg          , Gg          , Gg          , Gg          , Gg          , Gg          , Gg          , Gg          , Gg          , Gg          , Gg          , Gg          , Gg          , Gg          , Gg          , Gg          , Gg          , Gg          , Gg          , Gg          , Gg          , Gg          , Gg          , Gg          , Gg          , Gg          , Gg          , Gg          , Gg          , Gg          , Gg          , Gg          , Gg          , Gg          , Gg          , Gg          , Gg          , Gg          , Gg          , Gg          , Gg          , Gg          , Gg          , Gg          , Gg          , Gg          , Gg          
Gg          , Gg          , Qlf         , Qlf         , Gg          , Qlf         , Gg          , Qlf         , Gg          , Gg          , Gg          , Gg          , Qlf         , Qlf         , Qlf         , Gg          , Gg          , Gg          , Qlf         , Gg          , Gg          , Gg          , Gg          , Gg          , Qlf         , Gg          , Qlf         , Qlf         , Qlf         , Qlf         , Qlf         , Gg          , Gg          , Gg          , Qlf         , Qlf         , Qlf         , Gg          , Gg          , Gg          , Qlf         , Qlf         , Qlf         , Qlf         , Qlf         , Gg          , Qlf         , Qlf         , Qlf         , Qlf         , Qlf         , Gg          , Gg          , Qlf         , Qlf         , Gg          , Gg          , Gg          , Gg          , Qlf         , Gg          , Gg          
Gg          , Gg          , Qlf         , Gg          , Gg          , Gg          , Gg          , Qlf         , Gg          , Gg          , Gg          , Qlf         , Gg          , Gg          , Gg          , Qlf         , Gg          , Gg          , Qlf         , Qlf         , Qlf         , Gg          , Qlf         , Qlf         , Qlf         , Gg          , Qlf         , Gg          , Gg          , Gg          , Qlf         , Gg          , Gg          , Qlf         , Gg          , Gg          , Gg          , Qlf         , Gg          , Gg          , Gg          , Gg          , Qlf         , Gg          , Gg          , Gg          , Qlf         , Gg          , Gg          , Gg          , Gg          , Qlf         , Gg          , Qlf         , Gg          , Qlf         , Gg          , Gg          , Gg          , Qlf         , Gg          , Gg          
Gg          , Gg          , Qlf         , Gg          , Gg          , Gg          , Gg          , Gg          , Gg          , Gg          , Gg          , Qlf         , Gg          , Gg          , Gg          , Qlf         , Gg          , Gg          , Qlf         , Gg          , Qlf         , Gg          , Qlf         , Gg          , Qlf         , Gg          , Qlf         , Gg          , Gg          , Gg          , Qlf         , Gg          , Gg          , Qlf         , Gg          , Gg          , Gg          , Qlf         , Gg          , Gg          , Gg          , Gg          , Qlf         , Gg          , Gg          , Gg          , Qlf         , Gg          , Gg          , Gg          , Gg          , Gg          , Gg          , Qlf         , Gg          , Qlf         , Gg          , Gg          , Gg          , Qlf         , Gg          , Gg          
Gg          , Gg          , Qlf         , Gg          , Gg          , Gg          , Gg          , Gg          , Gg          , Gg          , Qlf         , Qlf         , Qlf         , Qlf         , Qlf         , Qlf         , Qlf         , Gg          , Qlf         , Gg          , Gg          , Qlf         , Gg          , Gg          , Qlf         , Gg          , Qlf         , Gg          , Qlf         , Gg          , Qlf         , Gg          , Qlf         , Qlf         , Qlf         , Qlf         , Qlf         , Qlf         , Qlf         , Gg          , Gg          , Gg          , Qlf         , Gg          , Gg          , Gg          , Qlf         , Gg          , Gg          , Gg          , Qlf         , Gg          , Gg          , Qlf         , Gg          , Qlf         , Qlf         , Gg          , Gg          , Qlf         , Gg          , Gg          
Gg          , Gg          , Qlf         , Gg          , Gg          , Gg          , Gg          , Gg          , Gg          , Gg          , Qlf         , Gg          , Gg          , Gg          , Gg          , Gg          , Qlf         , Gg          , Qlf         , Gg          , Gg          , Gg          , Gg          , Gg          , Qlf         , Gg          , Qlf         , Qlf         , Gg          , Qlf         , Gg          , Gg          , Qlf         , Gg          , Gg          , Gg          , Gg          , Gg          , Qlf         , Gg          , Gg          , Gg          , Qlf         , Gg          , Gg          , Gg          , Qlf         , Gg          , Gg          , Qlf         , Gg          , Qlf         , Gg          , Qlf         , Gg          , Gg          , Gg          , Qlf         , Gg          , Qlf         , Gg          , Gg          
Gg          , Gg          , Qlf         , Gg          , Gg          , Gg          , Gg          , Qlf         , Gg          , Gg          , Qlf         , Gg          , Gg          , Gg          , Gg          , Gg          , Qlf         , Gg          , Qlf         , Gg          , Gg          , Gg          , Gg          , Gg          , Qlf         , Gg          , Qlf         , Gg          , Gg          , Gg          , Gg          , Gg          , Qlf         , Gg          , Gg          , Gg          , Gg          , Gg          , Qlf         , Gg          , Gg          , Gg          , Qlf         , Gg          , Gg          , Gg          , Qlf         , Gg          , Gg          , Gg          , Gg          , Qlf         , Gg          , Qlf         , Gg          , Gg          , Gg          , Qlf         , Gg          , Qlf         , Gg          , Gg          
Gg          , Gg          , Qlf         , Qlf         , Qlf         , Qlf         , Qlf         , Qlf         , Gg          , Gg          , Qlf         , Gg          , Gg          , Gg          , Gg          , Gg          , Qlf         , Gg          , Qlf         , Gg          , Gg          , Gg          , Gg          , Gg          , Qlf         , Gg          , Qlf         , Gg          , Gg          , Gg          , Gg          , Gg          , Qlf         , Gg          , Gg          , Gg          , Gg          , Gg          , Qlf         , Gg          , Qlf         , Qlf         , Gg          , Qlf         , Qlf         , Gg          , Qlf         , Qlf         , Qlf         , Qlf         , Qlf         , Qlf         , Gg          , Qlf         , Gg          , Gg          , Gg          , Qlf         , Qlf         , Qlf         , Gg          , Gg          
Gg          , Gg          , Gg          , Gg          , Gg          , Gg          , Gg          , Gg          , Gg          , Gg          , Gg          , Gg          , Gg          , Gg          , Gg          , Gg          , Gg          , Gg          , Gg          , Gg          , Gg          , Gg          , Gg          , Gg          , Gg          , Gg          , Gg          , Gg          , Gg          , Gg          , Gg          , Gg          , Gg          , Gg          , Gg          , Gg          , Gg          , Gg          , Gg          , Gg          , Gg          , Gg          , Gg          , Gg          , Gg          , Gg          , Gg          , Gg          , Gg          , Gg          , Gg          , Gg          , Gg          , Qlf         , Gg          , Gg          , Gg          , Gg          , Gg          , Qlf         , Gg          , Gg          
Gg          , Gg          , Gg          , Gg          , Gg          , Gg          , Gg          , Gg          , Gg          , Gg          , Gg          , Gg          , Gg          , Gg          , Gg          , Gg          , Gg          , Gg          , Gg          , Gg          , Gg          , Gg          , Gg          , Gg          , Gg          , Gg          , Gg          , Gg          , Gg          , Gg          , Gg          , Gg          , Gg          , Gg          , Gg          , Gg          , Gg          , Gg          , Gg          , Gg          , Gg          , Gg          , Gg          , Gg          , Gg          , Gg          , Gg          , Gg          , Gg          , Gg          , Gg          , Gg          , Gg          , Gg          , Gg          , Gg          , Gg          , Gg          , Gg          , Gg          , Gg          , Gg          
